000010000
000111000
000111000
000111000
011111000
000111110
000111110
011111000
000011000
000110000
000011000
000111000
001111100
011111110
011111110
001111100
000111000
